******* 
*P     * 
*      * 
*      * 
*      * 
* M    G* 
******* 